# Underground Adventure - Level 2 Map
# More complex layout with multiple chambers

000000000000000000000000000000000
000000000000000000000000000000000
000000000000000000000000000000000

P0000111111111111111111111111111
000001111111111111111111111111111
111111111111111111111111111111111
111111111111111111111111111111111
11111100000E0000011111111111111111
111111000000000001111111111111111
111111111111111111111111111111111
111111111111111111111111R11111111
111111111111111111111111111111111
111111111111111111111111111111111
111111111111111111111111111111111
11111111111111E11111111111111111111
111111111111111111111111111111111
000000000000000000000000000000000
